NO Png_images/Walls/Wall_S.xpm
F 0,0,0
C 135,4,228
SO Png_images/Walls/Wall_S.xpm
EA Png_images/Walls/Wall_S.xpm
WE Png_images/Walls/Wall_S.xpm

1111111111
1000000001
1001D1DDD1
1000000001 
100000N001 
1111111111
