NO Png_images/Walls/Wall_N.xpm
SO Png_images/Walls/Wall_S.xpm
EA Png_images/Walls/Wall_E.xpm
WE Png_images/Walls/Wall_W.xpm
F 0,0,0
C 135,4,228

111111111111111
100000000000001
100000F00000001
100000000000001
100000000000001
10000000N000001
100000000000001
100000000000001
100000000F00001
100000000000001
111111111111111
