NO Png_images/Walls/Wall_N.xpm
SO Png_images/Walls/Wall_S.xpm
EA Png_images/Walls/Wall_E.xpm
WE Png_images/Walls/Wall_W.xpm
F 0,0,0
C 0,0,0

        11111B1111111111111111111
        10000000001100000000F0001
        1011000001110000000000001
        1001000000D00000000000001
111111111011000001110000000000001
100000000011000001110111111111111
1111011111111101110F000010001    
11110111111111011101010010001
11000000110101011100000010001
10000000000000001100000010001
100000000000000011010100100011
110000011101010111110011110000111
11110111 1100101 1011110100011
11111111 1101111 111111110111
        11101B1111111111101111111
        10000000001100000000F0001
        1011000001110000000000001
        1001000000D00000000000001
111111111011000001110000000000001
100000000011000001110111111111111
1111011111111101110F000010001    
11110111111111011101010010001
11000000110101011100000010001
10000000000000001100000010001
100000000000000011010100100011
11000001110001011111N011110000111
11110111 1100101 1011110100011
11111111 1101111 111111110111
        11101B1111111111101111111
        10000000001100000000F0001
        1011000001110000000000001
        1001000000D00000000000001
111111111011000001110000000000001
100000000011000001110111111111111
1111011111111101110F000010001    
11110111111111011101010010001
11000000110101011100000010001
10000000000000001100000010001
100000000000000011010100100011
110000011101010111110011110000111
11110111 1110101 1011110100011
11111111 1111111 111111111111
