NO ./raq/img/mewtwo.xpm
SO                           ./raq/img/gengar.xpme
EA ./raq/img/charizard.xpm

F                           255,100,0
WE                                      ./raq/img/jiggly.xpm
C       255,30,0

111111
100101
101001 111   1
110001      101
111111 111   1
 1
1S1      1111111
 1
