NO ./raq/img/mewtwo.xpm
SO                           ./raq/img/gengar.xpme
EA ./raq/img/charizard.xpm

F                           220,100,0
WE                                      ./raq/img/jiggly.xpm

C       255,30,0


1111
1001
1111    111
        1N 1 1 
        111
