111111111
100000001
100000001
100000001
111110001111
    10000001  11111
    10000001  10001
    10000001  11111
     111111




     111111
    10W0001
    10000001
    11111111
