NO Png_images/Walls/Wall_N.xpm
SO Png_images/Walls/Wall_S.xpm
EA Png_images/Walls/Wall_E.xpm
WE Png_images/Walls/Wall_W.xpm
F 0,0,0
C 135,4,228

1111
10001
10N01
1111