NO ./path_to_the_east_texture
SO ./path_to_the_east_texture
EA ./path_to_the_east_texture
WE ./path_to_the_east_texture
F 220,100,0
C 250,30,0

1111
10001
10N01
1111